# 0 = nothing
# 1 = wall
# 2 = player
# 3 = imposter
# 4 = vaporise btn
# 5 = release btn
# 6 = power up
# 7 = obstacle

1 1 1 1 1 1 1 1 1 1
1 1 7 0 0 3 0 0 6 1
1 1 0 1 1 0 1 1 0 1
1 1 0 1 1 0 1 1 0 1
1 1 0 1 1 2 1 1 0 1
1 1 0 1 1 0 1 1 0 1
1 1 4 0 0 0 0 0 5 1
1 1 1 1 1 0 1 1 1 1
1 1 1 1 0 0 0 1 1 1
1 1 1 1 1 0 1 1 1 1